A 3
18 44 69 31 90 72 48 29 55 37 78
103 85 39 55 51 8 80 37 21 65 54
5

A 3
18 41 63 30 84 95 67 29 71 48 91
96 77 40 67 49 75 76 31 19 60 47
5 6 11

B 7
86 36 55 88 10 82 53 107 83 22 15
69 38 48 73 21 50 27 1 41 24 103
8

B 10
69 41 96 89 53 42 83 95 48 4 25
100 71 90 59 86 97 84 85 79 81 98
None

A 3
18 44 69 31 70 72 48 29 55 37 78
103 85 39 55 51 8 80 37 21 65 54
None
